11111111111111111111111111111111111111111
100000000P0000000000000000000000000000001
10000000000000000000000000000000000000001
100000M0000000000000000000000000000000001
10101010101010101010101010000C00001111111
10000000000000000000001011111111111111111
10000000000000000000001011111111111111111
10000000000000000000001011111111111111111
1000M000000000000000001E11111111111111111
11111111111111111111111111111111111111111
