1111111111
1M000C0001
1CE000P001
1111111111